11111111111111111111
10C010P0100000C00101
10001000100101000001
10C01110101111111101
110C00000000C1000001
10001000100101001001
11011111111111111111
10001010100000010001
100C10101C01C0C0C1E1
11101010111111011111
1C000000100100000101
1111101010010010C001
10000C10001110111011
11011111100100100001
1001000C1011001001C1
1C0100101001000000C1
10C00010100001101111
10C11110110100000001
1001000010C100010001
11111111111111111111