1111111
1000CE1
1C00001
1111111