1111111
1P001E1
1C00111
1111111