1111111
1P000E1
1C00001
100011
1111111