1111111
1P00LE1
1C00OV1
1111111