1111111
1P00C01
1C00001
1111111