1111111111111
10P10C0000001
1100011111001
1C0011E0000C1
1111111111111