1111111111111111111111111111111111111111
1010000000000000000001000000000001111001
101P000101000001100000000000000C00000101
1010000000010000100100001000000000010001
10000C0010000111110000000000000000000001
1000001000000100000000110000001000010001
1001000000000100010000000000000000111001
1000010100000100000000100000000100010001
1000000100C00000010000000000110010001001
1000100010000000000100110000110000001001
1010000000100000110000000011000000000001
1000001101000100000000100000010000010001
1000000010100000000100C00000000010000111
1000001000010000000000000000000100110101
1100100000000010001100000000000000C00101
1010000001000001000000011000000100000001
101000C000000010000100000001100000100001
1001000000010000101000000000100000101001
10000001C00000000000100001000100000E0111
1111111111111111111111111111111111111111